#################
#.......@p.....
#..p............
#.........p.....
#...p...........
#.......###.....
#...............
####
.....