#####################
........#......p..#p#
#####.....#p.#....#p#
........@........##p#
..################pp#
...............p....#
#####################