#####################
........#......p..#p#
#####.....#..#....#.#
.....p..@........##.#
..################..#
...............p....#
#####################